NO	./bonus/parssing/src/Wall-Grass_01_L-128x128.xpm
SO	./bonus/parssing/src/Wall-Roofs_01_L-128x128.xpm
EA	./bonus/parssing/src/Wall-Stone_01_L-128x128.xpm
WE	./bonus/parssing/src/Wall-Tile_01_R-128x128.xpm
SO
C  	69, 179, 224
F	148, 118, 90

        1111111111111111111111111
        10000000D0000000000000001
        1000000DDD000000N00000001
        1111D11DD0000000000000001
        1000001000000000000100001
        1000001000000000000000001
        100000D000000000000000001
        1000001000000110000000001
        1000001000000010000000001
        11111111111D1111111111111
        1000000000000100D00000001
        1000000000000000100000001
        1111111111111111111111111