NO	./bonus/parssing/src/Wall-Grass_01_L-128x128.xpm
SO	./bonus/parssing/src/Wall-Roofs_01_L-128x128.xpm
EA	./bonus/parssing/src/Wall-Stone_01_L-128x128.xpm
WE	./bonus/parssing/src/Wall-Tile_01_R-128x128.xpm

C  	69, 179, 224
F	148, 118, 90

        1111111111111111111111111
        1D00000000000000000000001
        10000000000000D0W00000001
        1000000000000000000000001
        1000000000000000000010001
        1000000000000000000000001
        1000000000000000000000001
        1000000000000000000000001
        1000000000000000000000001
        1000000000000000000000DD1
        1111111111111111111111111