111111111111111111111111111111111111111111111111
100000000000000000000000000000000000000000000111
110000000000001000000001000000000000010000000111
110000000000001000000001000000010000000000000001
110000000000000001000000000000000100010000001111
110000000000000000000000000000000000000000000011
111111111111111111111110111111111111111111111111
111111111111111111111110111111111111111111111111
100000000000000000000000000000000000000000000111
110000000000000000000000000000000000000000000111
110000000000000000000000000000000000000000000001
110000000000000000000000000000000000000000001111
110000000000000000000000000000000000000000000011
111111111111111111111101111111111111111111111111
100000000000000000000000000000000000000000000111
110000000000001000000001000000000000010000000111
110000000000001000000001000000010000000000000001
110000000000000001000000000000000100010000001111
110000000000000000000000000000000000000000000011
111111111111111111111111011111111111111111111111
111111111111111111111111011111111111111111111111
100000000000000000000000000000000000000000000111
110000000000000000000000000000000000000000000111
110000000000000000000000000000000000000000000001
110000000000000000000000000000000000000000001111
110000000000000000000000000000000000000000000011
111111111111111111111111011111111111111111111111
100000000000000000000000000000000000000000000111
110000000000001000000001000000000000010000000111
110000000000001000000001000000010000000000000001
110000000000000001000000000000000100010000001111
110000000000000000000000000000000000000000000011
111111111111111111111111011111111111111111111111
111111111111111111111111011111111111111111111111
100000000000000000000000000000000000000000000111
110000000000000000000000000000000000000000000111
110000000000000000000000000000000000000000000001
110000000000000000000000000000000000000000001111
110000000000000000000000000000000000000000000011
111111111111111111111111111111111111111111111111