NO	./path_to_the_north_texture
EA	./path_to_the_east texture
WE	./path_to_the_west_texture
SO	./path_to_the_  south_texture

C	255,0,0   
F	255,255,255


111111111111111111111111111111111
 1000000000000000N000000000000001
  100000000000011111110000000001
   111111111111000000011111111