NO	./path_to_the_north_texture
EA	./path_to_the_east texture
WE	./path_to_the_west_texture
SO	./path_to_the_  south_texture

C	255,0,0   
F	255,255,255

xxx
111111111111111111111111111111111111
100000000000000000000000000000000001
100000000000000000000000000000000001
100000000000000000000000000000000001
100000000000000000000000000000000001
111111111111111111111111111111111111