1111111111111111111111111111111111111111111
1000000000000000000000000000000000000000111
110000000000000000000E000000000000000000011
110000000000000D000D00002030000000000000011
110000000000000000000E000000000000000000011
1100000000000000000000000000000000000001111
1111111111111011111111111111111111111111111
1111111111111101111111111111111111111111111
1100000000000000000000000000000000000000111
1100000000000000000000000000000000000000011
1110000000000000000000000000000000000000011
1110000000000000000000000000000000000001111
1111111111111111111111111111111111111111111
