NO	./parssing/src/Wall-Grass_01_L-128x128.xpm
SO	./path_to_the_south_texture
EA	./path_to_the_east texture
WE	./path_to_the_west_texture

C	200,0,50   
F	0,100,100

111111111111111111111111111111111
100000000000000000000000000011
100000000000W00000000000000011
100000000000000000000000000011
111111111111111111111111111111111
