1111111111111111111111111111111111111111111
1000000000000000000000000000000000000000111
11000000000000000000011000000000000000000011
110000000011000D000100001110000000000000011
110000000000000000000E000000000000000000011
1100000000000000000000000000000000000001111
1111111111111011111111111011111101111111111
1111111111111101111111111011111110111111111
1100000000000000000000011000000000000000111
1100000000110000000000000000000000000000011
1110000000110000000000011000000000000000011
1110000000000000000000000000000000000001111
1111111111111111111111111111111111111111111